00000000000000000000000000000000000000000000000000000000000000000000300000000000000001
00000000000000000000000000000000000000000000000000000000000000000000222222222222222221
00000000000000000000000000000000000000000000220000000000000000000000000011111111111111
00000000003000000000000000000000000000030000112200000220000000000000000000000111111111
00000002222200000000000000000000222000222000111100000110000022222222000000000000000001
00000000000000000000000002200000000000000000111100000110000011111111222200000000000031
22000000000000000220000001122000000000000000111100000110000011111111111122220000000021
11222222222222222110000221111222222222222222111100000110000011111111111111112222222211
11111111111111111110000111111111111111111111111100000010000011111111111111111111111111
11111111111111111110000111111111111111111111111100000010000011111111111111111111111111
11111111111111111110000111111111111111111111111100000010000000111111111111111111111111
11111111111111111110000111111111111111111111111100000010000000000000111111111111111111
11111111111111111110000111111111111111111111111100000010000011111111111111111111111111

